200
15
1 0 0 0 0 0 0 0 0 0 0 0 0 0 0 0 0 0 0 0 0 0 0 0 0 0 0 0 0 0 0 0 0 0 0 0 0 0 0 0 0 0 0 0 0 0 0 0 0 0 0 0 0 0 0 0 0 0 0 0 0 0 0 0 0 0 0 0 0 0 0 0 0 0 0 0 0 0 0 0 0 0 0 0 0 0 0 0 0 0 0 0 0 0 0 0 0 0 0 0 0 0 0 0 0 0 0 0 0 0 0 0 0 0 0 0 0 0 0 0 0 0 0 0 0 0 0 0 0 0 0 0 0 0 0 0 0 0 0 0 0 0 0 0 0 0 0 0 0 0 0 0 0 0 0 0 0 0 0 0 0 0 0 0 0 0 0 0 0 0 0 0 0 0 0 0 0 0 0 0 0 0 0 0 0 0 0 0 0 0 0 0 0 0 0 0 0 0 1 1
1 0 0 0 0 0 0 0 0 0 0 0 0 0 0 0 0 0 0 0 0 0 0 0 0 0 0 0 0 0 0 0 0 0 0 0 0 0 0 0 0 0 0 0 0 0 0 0 0 0 0 0 0 0 0 0 0 0 0 0 0 0 0 0 0 0 0 0 0 0 0 0 0 0 0 0 0 0 0 0 0 0 0 0 0 0 0 0 0 0 0 0 0 0 0 0 0 0 0 0 0 0 0 0 0 0 0 0 0 0 0 0 0 0 0 0 0 0 0 0 0 0 0 0 0 0 0 0 0 0 0 0 0 0 0 0 0 0 0 0 0 0 0 0 0 0 0 0 0 0 0 0 0 0 0 0 0 0 0 0 0 0 0 0 0 0 0 0 0 0 0 0 0 0 0 0 0 0 0 0 0 0 0 0 0 0 0 0 0 0 0 0 0 0 0 0 0 0 1 1
1 0 0 0 0 0 0 0 0 0 0 0 0 0 0 0 0 0 0 0 0 0 0 0 0 0 0 0 0 0 0 0 0 0 0 0 0 0 0 0 0 0 0 0 0 0 0 0 0 0 0 0 0 0 0 0 0 0 0 0 0 0 0 0 0 0 0 0 0 0 0 0 0 0 0 0 0 0 0 0 0 0 0 0 0 0 0 0 0 0 0 0 0 0 0 0 0 0 0 0 0 0 0 0 0 0 0 0 0 0 0 0 0 0 0 0 0 0 0 0 0 0 0 0 0 0 0 0 0 0 0 0 0 0 0 0 0 0 0 0 0 0 0 0 0 0 0 0 0 0 0 0 0 0 0 0 0 0 0 0 0 0 0 0 0 0 0 0 0 0 0 0 0 0 0 0 0 0 0 0 0 0 0 0 0 0 0 0 0 0 0 0 0 0 0 0 0 0 1 1
1 0 0 0 0 0 0 0 0 0 0 0 0 0 0 0 0 0 0 0 0 0 0 0 0 0 0 0 0 0 0 0 0 0 0 0 0 0 0 0 0 0 0 0 0 0 0 0 0 0 0 0 0 0 0 0 0 0 0 0 0 0 0 0 0 0 0 0 0 0 0 0 0 0 0 0 0 0 0 0 0 0 0 0 0 0 0 0 0 0 0 0 0 0 0 0 0 0 0 0 0 0 0 0 0 0 0 0 0 0 0 0 0 0 0 0 0 0 0 0 0 0 0 0 0 0 0 0 0 0 0 0 0 0 0 0 0 0 0 0 0 0 0 0 0 0 0 0 0 0 0 0 0 0 0 0 0 0 0 0 0 0 0 0 0 0 0 0 0 0 0 0 0 0 0 0 0 0 0 0 0 0 0 0 0 0 0 0 0 0 0 0 0 0 0 0 0 0 1 1
1 0 0 0 0 0 0 0 0 0 0 0 0 0 0 0 0 0 0 0 0 0 0 0 0 0 0 0 0 0 0 0 0 0 0 0 0 0 0 0 0 0 0 0 0 0 0 0 0 0 0 0 0 0 0 0 0 0 0 0 0 0 0 0 0 0 0 0 0 0 0 0 0 0 0 0 0 0 0 0 0 0 0 0 0 0 0 0 0 0 0 0 0 0 0 0 0 0 0 0 0 0 0 0 0 0 0 0 0 0 0 0 0 0 0 0 0 0 0 0 0 0 0 0 0 0 0 0 0 0 0 0 0 0 0 0 0 0 0 0 0 0 0 0 0 0 0 0 0 0 0 0 0 0 0 0 0 0 0 0 0 0 0 0 0 0 0 0 0 0 0 0 0 0 0 0 0 0 0 0 0 0 0 0 0 0 0 0 12 0 0 0 0 0 0 0 0 0 1 1
1 0 0 0 0 0 0 0 0 0 0 0 0 0 0 0 0 0 0 0 33 0 0 0 0 0 0 0 0 0 0 0 0 0 0 0 0 0 0 0 0 0 0 0 0 0 0 0 0 0 0 0 0 0 0 0 0 0 0 0 0 0 0 0 0 0 0 0 0 0 0 0 0 0 0 0 0 0 0 14 14 14 14 14 14 14 14 14 0 0 0 14 14 14 33 0 0 0 0 0 0 0 0 0 0 0 0 0 0 33 0 0 0 0 0 0 0 0 0 0 0 14 14 14 0 0 0 0 14 33 33 14 0 0 0 0 0 0 0 0 0 0 0 0 0 0 0 0 0 0 0 0 0 0 0 0 0 0 0 0 0 0 0 0 0 0 0 0 0 0 0 0 0 0 0 0 0 0 0 0 0 0 0 0 0 0 0 12 12 0 0 0 0 0 0 0 0 0 1 1
1 0 0 0 0 0 0 0 0 0 0 0 0 0 0 0 0 0 0 0 0 0 0 0 0 0 0 0 0 0 0 0 0 0 0 0 0 0 0 0 0 0 0 0 0 0 0 0 0 0 0 0 0 0 0 0 0 0 0 0 0 0 0 0 0 0 0 0 0 0 0 0 0 0 0 0 0 0 0 0 0 0 0 0 0 0 0 0 0 0 0 0 0 0 0 0 0 0 0 0 0 0 0 0 0 0 0 0 0 0 0 0 0 0 0 0 0 0 0 0 0 0 0 0 0 0 0 0 0 0 0 0 0 0 0 0 0 0 0 0 0 0 0 0 0 0 0 0 0 0 0 0 0 0 0 0 0 0 0 0 0 0 0 0 0 0 0 0 0 0 0 0 0 0 0 0 0 0 0 0 0 0 0 0 0 0 12 12 12 0 0 0 0 0 0 0 0 0 1 1
1 0 0 0 0 0 0 0 0 0 0 0 0 0 0 0 0 0 0 0 0 0 0 0 0 0 0 0 0 0 0 0 0 0 0 0 0 0 0 0 0 0 0 0 0 0 0 0 0 0 0 0 0 0 0 0 0 0 0 0 0 0 0 0 0 0 0 0 0 0 0 0 0 0 0 0 0 0 0 0 0 0 0 0 0 0 0 0 0 0 0 0 0 0 0 0 0 0 0 0 0 0 0 0 0 0 0 0 0 0 0 0 0 0 0 0 0 0 0 0 0 0 0 0 0 0 0 0 0 0 0 0 0 0 0 0 0 0 0 0 0 0 0 0 0 0 0 0 0 0 0 0 0 0 0 0 0 0 0 0 0 0 0 0 0 0 0 0 0 0 0 0 0 0 0 0 0 0 0 0 0 0 0 0 0 12 12 12 12 0 0 0 0 0 0 0 0 0 1 1
1 0 0 0 0 0 0 0 0 0 0 0 0 0 0 0 0 0 0 0 0 0 0 0 0 0 0 0 0 0 0 0 0 0 0 0 0 0 0 0 0 0 0 0 0 0 0 0 0 0 0 0 0 0 0 0 0 0 0 0 0 0 0 0 0 0 0 0 0 0 0 0 0 0 0 0 0 0 0 0 0 0 0 0 0 0 0 0 0 0 0 0 0 0 0 0 0 0 0 0 0 0 0 0 0 0 0 0 0 0 0 0 0 0 0 0 0 0 0 0 0 0 0 0 0 0 0 0 0 0 0 0 0 0 0 0 0 0 0 0 0 0 0 0 0 0 0 0 0 0 0 0 0 0 0 0 0 0 0 0 0 0 0 0 0 0 0 0 0 0 0 0 0 0 0 0 0 0 0 0 0 0 0 0 12 12 12 12 12 0 0 0 0 0 0 0 0 0 1 1
1 0 0 0 0 0 0 0 0 0 0 0 0 0 33 0 0 0 14 33 14 34 14 0 0 0 0 0 0 0 0 0 0 0 0 0 0 0 0 0 0 0 0 0 0 0 1 1 0 0 0 0 0 0 0 0 1 1 0 0 0 0 0 0 0 0 0 0 0 0 0 0 0 0 0 0 14 33 14 0 0 0 0 0 0 0 0 0 0 0 0 0 0 0 0 0 0 0 0 0 14 14 0 0 0 0 33 0 0 33 0 0 33 0 0 0 0 0 14 0 0 0 0 0 0 0 0 0 0 14 14 0 0 0 0 0 0 12 0 0 12 0 0 0 0 0 0 0 0 0 0 12 0 0 12 0 0 0 0 0 0 0 0 0 0 0 0 14 14 23 14 0 0 0 0 0 0 0 0 0 0 0 0 12 12 12 12 12 12 0 0 0 0 0 0 0 0 0 1 1
1 0 0 0 0 0 0 0 0 0 0 0 0 0 0 0 0 0 0 0 0 0 0 0 0 0 0 0 0 0 0 0 0 0 0 0 1 1 0 0 0 0 0 0 0 0 1 1 0 0 0 0 0 0 0 0 1 1 0 0 0 0 0 0 0 0 0 0 0 0 0 0 0 0 0 0 0 0 0 0 0 0 0 0 0 0 0 0 0 0 0 0 0 0 0 0 0 0 0 0 0 0 0 0 0 0 0 0 0 0 0 0 0 0 0 0 0 0 0 0 0 0 0 0 0 0 0 0 0 0 0 0 0 0 0 0 12 12 0 0 12 12 0 0 0 0 0 0 0 0 12 12 0 0 12 12 0 0 0 0 0 0 0 0 0 0 0 0 0 0 0 0 0 0 0 0 0 0 0 0 0 0 12 12 12 12 12 12 12 0 0 0 0 0 0 0 0 0 1 1
1 0 0 0 0 0 0 0 0 0 0 0 0 0 0 0 0 0 0 0 0 0 0 0 0 0 1 1 0 0 0 0 0 0 0 0 1 1 0 0 0 0 0 0 0 0 1 1 0 0 0 0 0 0 0 0 1 1 0 0 0 0 0 0 0 0 0 0 0 0 0 0 0 0 0 0 0 0 0 0 0 0 0 0 0 0 0 0 0 0 0 0 0 0 0 0 0 0 0 0 0 0 0 0 0 0 0 0 0 0 0 0 0 0 0 0 0 0 0 0 0 0 0 0 0 0 0 0 0 0 0 0 0 0 0 12 12 12 0 0 12 12 12 0 0 0 0 0 0 12 12 12 0 0 12 12 12 0 0 0 0 0 1 1 0 0 0 0 0 0 0 0 0 0 0 0 0 0 1 1 0 12 12 12 12 12 12 12 12 0 0 0 0 0 0 0 0 0 1 1
1 0 0 0 0 0 0 0 0 0 0 20 0 0 0 0 0 0 0 0 0 0 0 0 0 0 1 1 0 0 0 0 0 0 0 0 1 1 0 0 0 0 0 0 0 0 1 1 0 0 0 0 0 0 0 0 1 1 0 0 0 0 0 0 0 0 0 0 0 0 0 0 0 0 0 0 0 0 0 0 0 0 0 0 0 0 0 0 0 0 0 0 0 0 0 0 0 0 0 0 0 0 0 0 0 0 0 0 0 0 0 0 0 0 0 0 0 0 0 0 0 0 0 0 0 0 0 0 0 0 0 0 0 0 12 12 12 12 0 0 12 12 12 12 0 0 0 0 12 12 12 12 0 0 12 12 12 12 0 0 0 0 1 1 0 0 0 0 0 0 0 0 0 0 0 0 0 0 1 1 12 12 12 12 12 12 12 12 12 0 0 0 0 0 0 0 0 12 1 1
10 10 10 10 10 10 10 10 10 10 10 10 10 10 10 10 10 10 10 10 10 10 10 10 10 10 10 10 10 10 10 10 10 10 10 10 10 10 10 10 10 10 10 10 10 10 10 10 10 10 10 10 10 10 10 10 10 10 10 10 10 10 10 10 10 10 10 10 0 0 10 10 10 10 10 10 10 10 10 10 10 10 10 10 10 0 0 0 0 10 10 10 10 10 10 10 10 10 10 10 10 10 10 10 10 10 10 10 10 10 10 10 10 10 10 10 10 10 10 10 10 10 10 10 10 10 10 10 10 10 10 10 10 10 10 10 10 10 10 10 10 10 10 10 10 10 10 10 10 10 10 10 0 0 10 10 10 10 10 10 10 10 10 10 10 10 10 10 10 10 10 10 10 10 10 10 10 10 10 10 10 10 10 10 10 10 10 10 10 10 10 10 10 10 10 10 10 10 10 10
10 10 10 10 10 10 10 10 10 10 10 10 10 10 10 10 10 10 10 10 10 10 10 10 10 10 10 10 10 10 10 10 10 10 10 10 10 10 10 10 10 10 10 10 10 10 10 10 10 10 10 10 10 10 10 10 10 10 10 10 10 10 10 10 10 10 10 10 0 0 10 10 10 10 10 10 10 10 10 10 10 10 10 10 10 0 0 0 0 10 10 10 10 10 10 10 10 10 10 10 10 10 10 10 10 10 10 10 10 10 10 10 10 10 10 10 10 10 10 10 10 10 10 10 10 10 10 10 10 10 10 10 10 10 10 10 10 10 10 10 10 10 10 10 10 10 10 10 10 10 10 10 0 0 10 10 10 10 10 10 10 10 10 10 10 10 10 10 10 10 10 10 10 10 10 10 10 10 10 10 10 10 10 10 10 10 10 10 10 10 10 10 10 10 10 10 10 10 10 10
338
1 1 2 5 3 80 16 80 48
1 9 9 3 2 0 32 48 32
1 14 2 4 2 80 16 80 32
1 18 11 3 2 0 32 48 32
1 28 8 3 2 0 32 48 32
1 11 2 3 1 0 16 48 16
1 21 2 3 1 0 16 48 16
1 26 2 2 2 48 32 32 32
1 36 3 2 2 48 32 32 32
1 36 2 2 1 48 48 32 16
1 46 4 2 2 48 32 32 32
1 46 2 2 2 48 48 32 16
1 41 2 3 1 0 16 48 16
1 48 2 5 3 80 16 80 48
1 56 4 2 2 48 32 32 32
1 56 2 2 2 48 48 32 16
1 162 2 2 2 48 32 32 32
1 178 2 2 2 48 32 32 32
51 24 11
50 33 12
50 39 12
51 25 12
80 35 8
80 30 8
81 44 8
50 20 8
50 20 4
51 24 10
51 24 9
51 23 7
51 22 5
51 16 3
51 13 1
51 15 4
51 19 6
51 23 4
51 18 2
51 18 4
51 20 6
51 14 6
51 9 6
51 11 6
51 20 7
51 25 7
51 27 8
51 25 10
51 21 11
51 16 11
50 22 7
50 19 6
50 15 6
50 13 6
50 11 4
50 12 2
50 14 1
50 17 1
50 21 2
50 25 3
50 27 4
50 24 4
50 19 2
50 16 3
50 13 4
50 12 5
50 11 7
50 10 9
50 16 12
50 18 12
50 20 12
50 16 9
50 17 7
50 18 7
50 30 10
50 30 10
50 34 8
50 32 6
50 29 5
50 32 2
50 37 3
50 39 5
50 41 6
50 43 5
50 44 3
50 46 6
50 48 8
50 50 6
50 52 3
50 55 8
50 58 6
50 59 3
50 60 5
50 61 7
50 63 6
50 66 3
50 67 5
50 69 7
50 72 5
50 74 4
50 75 6
50 77 6
50 80 4
50 82 4
50 84 6
50 86 6
50 89 5
50 91 4
50 92 7
50 94 8
50 97 6
50 100 4
50 101 7
50 103 7
50 106 4
50 108 4
50 109 7
50 112 7
50 114 4
50 116 6
50 117 8
50 120 6
50 126 6
50 128 3
50 131 4
50 134 4
50 135 7
50 137 7
50 138 7
50 138 4
50 141 6
50 142 8
50 144 9
50 149 9
50 151 7
50 154 6
50 156 7
50 157 8
50 159 9
50 160 10
50 164 7
50 167 7
50 169 7
50 172 6
50 172 9
50 172 11
50 173 11
50 177 8
50 179 8
50 181 7
50 183 6
51 172 3
51 171 3
51 166 3
51 165 7
51 163 8
51 160 6
51 156 3
51 152 5
51 151 7
51 148 4
51 144 1
51 143 6
51 144 9
51 139 8
51 137 4
51 133 2
51 130 3
51 128 3
51 126 1
51 123 4
51 127 7
51 125 9
51 124 10
51 122 11
51 120 9
51 116 4
51 114 2
51 105 2
51 105 3
51 104 6
51 104 3
51 102 3
51 99 4
51 99 2
51 99 2
51 92 1
51 89 1
51 86 9
51 86 10
51 81 10
51 78 7
51 71 7
51 72 10
51 71 11
51 67 9
51 65 7
51 64 8
51 62 10
51 58 9
51 59 9
51 53 5
51 54 3
51 53 9
51 53 10
51 51 9
51 51 8
51 47 3
51 48 2
51 40 1
51 40 2
51 40 4
51 35 1
51 35 3
51 36 5
51 29 1
51 28 2
51 28 6
51 29 7
51 33 6
51 34 5
51 36 7
51 39 8
51 38 10
51 37 11
51 40 10
51 42 11
51 42 10
51 42 9
51 43 6
51 47 4
51 48 1
51 43 1
51 46 1
51 50 2
51 50 9
51 54 7
51 57 3
51 60 1
51 63 1
51 65 4
51 67 5
51 68 1
51 67 1
51 71 2
51 69 4
51 75 1
51 77 2
51 77 3
51 79 2
51 81 1
51 84 2
51 86 8
51 83 8
51 82 7
51 87 10
51 86 13
51 83 11
51 89 9
51 89 3
51 87 2
51 86 0
51 98 1
51 99 7
51 98 11
51 101 12
51 104 12
51 111 11
51 114 8
51 114 2
51 119 1
51 122 2
50 131 8
50 127 12
50 125 7
50 121 6
50 117 2
50 113 1
50 111 3
50 108 7
50 103 6
50 104 3
50 102 1
50 99 2
50 95 2
50 93 2
50 91 8
50 89 8
50 90 10
50 88 11
50 85 10
50 84 8
50 80 6
50 75 3
50 73 1
50 72 2
50 72 5
80 70 6
80 62 4
80 62 8
80 62 10
80 53 7
81 57 4
81 49 3
81 49 7
81 49 9
81 72 10
81 77 6
81 82 8
81 84 10
81 89 8
81 91 6
81 93 5
81 96 8
81 98 10
81 102 6
81 105 6
81 107 8
81 109 10
81 114 6
81 118 6
81 120 7
81 122 10
81 124 10
81 128 7
80 143 3
80 142 2
80 144 5
80 144 9
80 152 5
80 155 3
80 158 7
80 162 8
80 165 3
80 166 1
80 173 7
80 176 10
80 180 4
80 181 2
80 186 4
